#######S#################################
#   #   #     # #   # #   # # #     # # #
### ### ##### # ### # # ### # ##### # # #
# # # # # # # # #   # # # #   # #     # #
# # # # # # # # ### # # # # ### ##### # #
#       #   #         # # # # #     # # #
####### ### ######### # # # # ##### # # #
# # #   # #   # # #         # # # #     #
# # ### # # ### # ### ### ### # # ### ###
# # #     # #     #   #   # # #   #     #
# # ##### # ### ##### ### # # ### ### ###
#       #   #   #   # #       #   #   # #
### ### # ##### ### #asdfff ##### ### # #
#   #       # # #   #         #         #
### ### ##### # ### ### ### ########### #
# # #   # #     # #     #     # # # #   #
# ##### # ##### # ### ##### ### # # ### #
# #       # # #     # # #     # #       #
# ##### ### # ### ##### ### ### ####### #
# # #     # # # #   # # # # # #   # #   #
# # ### ### # # # ### # # # # # ### ### #
#         # #     #             # # # # #
# ##### ### # ########### ##### # # # # #
# #     #     # # # # #   # # #         #
####### ##### # # # # ##### # ### # ### #
# #     # # # # #   #   #   # # # # # # #
# ##### # # # # # ### ##### # # ##### # #
#           # # # # # #     # #   #     #
# ### # ### # # # # # ##### # # ##### ###
# #   # #             # # # #   # # #   #
# ### ##### ####### ### # # # ### # # ###
# #     #   # # #   # #   # # # #       #
##### ####### # ### # ### # # # # #######
#     #         #   #                   #
# ######### ### ### ##### # # # # # # ###
# #     #   #   #         # # # # # #   #
####### ####### ### # ### # ##### ### # #
#                   # #   # #       # # #
####### # # # # ### ##### # # ### ##### #
#       # # # # #     #   # # #       # #
#########################E###############