#########s#
#   #     #
###   ### #
#  ## #   #
##   #  ###
## #   ## #
#   # ##  #
## ###   ##
#   #  #  #
# #   ### #
#####e#####