#####S###################################
# # #  ##  # #     #   #  #   #    #    #
#    #   #     ## #  # ##   #  # #   ## #
## #  ##  ######    ##  ## # # ## # #   #
#  # #   #       #### #    # #     #  # #
## ##  ##  ### ##      ## #   #### # #  #
##    #   #   # # # ##   #  #    # #  # #
#  # #  #  # #  # #   #### #  ## #   #  #
##  # #  # #   #  # #      ## # #  #### #
# # # ## #  # #  # # # ## # #    ##  #  #
# # #    ## #  # #    ## #   ###    ## ##
#   # ###   # #  ####      ##   ## #   ##
## #  #   ##   #     # ## #   #  #   ## #
#  # #  ##   #  ### #  #  # #  #  # ##  #
# # #  #  ###  #  # ##  ##  ##  #  #   ##
# #   #  #    ## ##   #    #   #  #  # ##
# ## # #   ##    # ##  # ##  ##  #  ##  #
#    #   ## # ##   # # ##   # # # # #  ##
## ##  # #     ## #     # ##    #   # # #
# #   ##  ## #  ##  ####  #  # ### #  # #
#  # #  #   # ##   ##    # ##   ## # ## #
##     #  #      #    # #     #    #    #
#######################################E#