penis####S#
#   #     #
pe#   ### #
#  ## #   #
##   #  ###
:) #   ## #
#   # cx  #
## tee   #y
#   #  #  t
# #   ### e
#####EAXCD#