* *********
* *********
*        **
**** *** **
***  *** **
**  **   **
** **  ****
** ********
**        *
********* *
********* *